9 9
00 00 00 00 00 00 00 00 00
00 00 00 23 23 23 00 00 00
00 00 22 17 19 19 24 00 00
00 00 02 01 01 20 02 00 00
00 00 02 01 01 20 02 00 00
00 02 01 01 01 01 07 02 00
00 02 01 01 01 01 01 02 00
00 02 02 02 02 02 02 02 00
00 00 00 00 00 00 00 00 00
